<layout>
XXXXXXXXXXXX_XXXXXXXXXXXX
XXXXXXXXXXX   XXXXXXXXXXX
XXXXXXXXXXX             X
XXXXXXXXXXXXXXXXXXXXX   X
X                       X
X  XXXXXXXXXXXXXXXXXXXXXX
X              XXXXXXXXXX
XXXXXXXXXXXX   XXXXXXXXXX
XXXXXXXXXXXX   XXXXXXXXXX
XXXXXXXXXXXXXXXXXXXXXXXXX
</layout>
~UP=rooms/002.txt

