<layout>
XXXXXXXXXXXX_XXXXXXXXXXXX
XXXXXXXXXXX   XXXXXXXXXXX
XXXXXXXXXXX             X
XXXXXXXXXXX    XXXXXX   X
X                       X
X  XXXXXXXXX   XXXXXXXXXX
X              XXXXXXXXXX
XXXXXXXXXXXX   XXXXXXXXXX
XXXXXXXXXXXX   XXXXXXXXXX
XXXXXXXXXXXXXXXXXXXXXXXXX
</layout>
~UP=rooms/002.txt

