<layout>
XXXXXXXXXXXX_XXXXXXXXXXXX
XXXXXXXXXXX   XXXXXXXXXXX
XXXXXXXXXXX             X
XXXXXXXXXXXXXXXXXXXXX   X
X                       X
X   XXXXXXXXXXXXXXXXXXXXX
X   *          XXXXXXXXXX
X   \          XXXXXXXXXX
XXXXXXXXXXXX   XXXXXXXXXX
XXXXXXXXXXXXXXXXXXXXXXXXX
</layout>
~UP=rooms/002.txt

