<layout>
##########################################################
#                   TIME HAS RUN OUT                     #
#                      Y0U LOSE :(                       #
#                                                        #
#                       press "q"                        #
##########################################################
</layout>
