<layout>
##########################################################
#               THE CR0WN HAS BEEN RETURNED              #
#                      Y0U WIN!!!                        #
#                                                        #
#                       press "q"                        #
##########################################################
</layout>
